######     ######
#    #     #    #
#    #######    #
#    #  $    @ .#
#    #######    #
#    #     #    #
#    #     #    #
######     ######
; 4

######     ######
#    #     #    #
#    #######    #
#       $  # @ .#
#    #######    #
#    #     #    #
#    #     #    #
######     ######
; 3